open	source
semantics	formal
procedural	code
portability	market
compound	statements
coercion	operations
structured	dynamic
plugin	coding
development	naming
culture	healthcare
web	pages
filepython	logo
procedural	functional
groovybeans	properties
codebase	transcompiler
language	intermediate
reception	naming
security	crosssite
dialects	major
documentation	generator
restarts	separate
latest	additions
embeddable	runtime
at	netscape
mclaughlins	smog